1, 3
34, 19
0, 14; 6, 19; 9, 15; 7, 8; 1, 9
2, 6; 17, 6; 17, 1; 2, 1
12, 15; 14, 8; 10, 8
14, 19; 18, 20; 20, 17; 14, 13
18, 10; 23, 6; 19, 3
22, 19; 28, 19; 28, 9; 22, 9
25, 6; 29, 8; 31, 6; 31, 2; 28, 1; 25, 2
31, 19; 34, 16; 32, 8; 29, 17